FFFFFFPFFFFFFF
FFFWWGTTTTTTTH
FFFWGGTGGGGGGF
FFGGGGTGGGGGGG
FFGTTTTTGGGGGG
FFETTTTTTTTTT<
FFTTTGGGGWWWWW
FFTTGGGGWWWWWW
FFTGGGGGWWWWWW
FFTGGGGGWWWWWW
FFTFGGGGWWWWWW
FTTFGGGGWWWWWW
FTFGGGGGWWWWWW
F\FGGGGWWWWWWW
FXFGWWWWWWWWWW