FFFFFFPFFFFFFF
FFFFGGTGGFFFFF
FFFFGGTGFFFFFF
FFFFGGTTTFFFFF
FFFFGTTF1FFFFF
FFFFGXFFOFFFFF
FFFFFFFFFFFFFF
FFFFFFFFFFFFFF
FFFFFFFFFFFFFF
FFFFFFFFFFFFFF
FFFFFFFFFFFFFF
FFFFFFFFFFFFFF
FFFFFFFFFFFFFF
FFFFFFFFFFFFFF