FFFXT3FFWWWWWWW
FFF\FOFWWWWWWWW
FFF|FFWWWWWWWWW
FFF/GFFFFWWWWWW
FFGTTTTTTETTTT<
FGGTTGGGGGGGGGG
GGTTGGGGGEGGWWW
PTTTTTTGGGGGGWW
GGTGGGGGGGFFFFF
GGTGGGGGGFFFFFF
GGTTTTTTTEEE!HH
>TETGGGGGFFFFFF
FGGGGGGGGGGGGGF
FFFFFFFFFFFFFFF
FFFFFFFFFFFFFFF
FFFFFFFFFFFFFFF
