FFFPFFWWWWWWWWW
FFFTFFFWWWWWWWW
FFGTFTTTWWWWWWW
FGTTTTFTTETFFFW
GTTGGGFFFFTET>F
GTGGGGFFFFFFFFF
GTTTTTTTTTTGGGG
GGGGGGGGGGEGG!G
GGGGGGGGTTTGGFF
GGGTTTTTTGGGGGG
FFFTFFFTTGGGGGG
FFFTFFFTFGGGGGG
FFFTFFF|FGGGGGG
#T/TFFFTFGGGGGG
FFFFFFFTFGGGGGG
WWWWFFFXFGGGGGG
