FPFFEFFFFFFFFFF
FTFGTGGGGGGGEFF
FTTTTTGGGGGGTFF
FGTTTTTTTTTTT@F
FGTTGGGGGGWWWWF
FGTGGGT2GWWWWWF
FGTTTTTOGGWWWWF
FGTTGGTHGWWWWWF
FFTGGGGGWWWWWWF
FFTGGGGGGFFFFFF
FFTTGGGGFFFFFFF
FFFTGGGGGFFFFFF
FFFTGGGGGFFFFFF
FFFTGGGGGFFFFFF
FFFXGGGGGFFFFFF