FFFFFFPFFFFFFF
FFFFFGTGFFFFFF
FFFFFGTGFFFFFF
FFFFFGTGFFFFFF
FFFFFGTGFFFFFF
FFFFFGTGFFFFFF
FFFFGGTTTFFFFF
FFFFGGTG1FFFFF
FFFFGGTFOFFFFF
FFFFTTTFFFFFFF
FFFFTFFFFFFFFF
FFFFXFFFFFFFFF
FFFFFFFFFFFFFF
FFFFFFFFFFFFFF